     #####################################
    ######################################
   ###.................................###
  ###..................................###
 ###...................................###
###....................................###
###....................................###
###.....##########.....###########.....###
###.....###########...############.....###
###.....###......###..###..............###
###.....###......###..###..............###
###.....###......###..###..............###
###.....###......###..###..............###
###.....###########...###########......###
###.....###########....###########.....###
###.....###......###...........###.....###
###.....###......###...........###.....###
###.....###......###...........###.....###
###.....###......###...........###.....###
###.....###########...############.....###
###.....##########....###########......###
###....................................###
###....................................###
###...................................### 
###..................................###  
###.................................###   
######################################    
#####################################     